Map-------------------------------------------------------------
|..............................................................|
|..............................................................|
|..............................................................|
|..............................................................|
|..............................................................|
|..............................................................|
|..............................................................|
|..............................................................|
|..............................................................|
|..............................................................|
|..............................................................|
|..............................................................|
|..............................................................|
|..............................................................|
|..............................................................|
|..............................................................|
|..............................................................|
|..............................................................|
|..............................................................|
|..............................................................|
|..............................................................|
|..............................................................|
|..............................................................|
|..............................................................|
|..............................................................|
|..............................................................|
|..............................................................|
|..............................................................|
|..............................................................|
|..............................................................|
|..............................................................|
|..............................................................|
|..............................................................|
|..............................................................|
|..............................................................|
|..............................................................|
|..............................................................|
|..............................................................|
----------------------------------------------------------------
